11111111111111111111111111111111111111111111111111111111111
10010000000000000001000000000000000000000000000000000000011
10000000100001000010000000101010101010101010101010101010011
10000000001000000000000001100000000000000000000000000000111
10000000000000010000100001100000000000000000000000000000111
10001000000000010000100011110000111111111111111111111111111
10000000001000010000000001111000000000000000000000000000011
10000010001000100000000001111111110111111011111111100000111
10010000010000100001000000111101111111111111101111110001111
10000000111000010000000000000000000000000000000000000011111
10000100000000010000100000000000000000000000000000000111111
10010000000010000100000000000000000000000000000000001111111
11111111111111111111111111111111111111111111111111111111111